 , , , , , , ,=, , ,@,@,@,@,@;
 ,Z,Z, , , , ,=, , ,@, ,@, ,@;
 ,Z,Z, , , , ,=,@,@,@, ,@, ,@;
 , , ,P, ,~,~,=, , , ,B, ,B, ;
 , , ,H,H,H, ,=, ,O,O, , , , ;
 , , ,H, , , , , ,+, , , , , ;
 ,B, ,H, , ,T, ,T,P, , , ,O,O;
=,=,=,=,=, , ,T, ,P,=,=,=,=,=;
 , , ,C,C, ,T, ,T, , , ,=, , ;
 , , ,C,C, , , , ,~,~, ,#,#,B;
 , , ,C,C, , ,=, , , , ,#,#, ;
~,~, ,C,C, , ,=,O,O,O,B,#,#, ;
 , ,+, , , ,O,=, , , , , , ,~;
 , ,O,@,@,@, ,=, ,H,H, , , ,~;
 , , ,@,B,@, ,=, , , , , ,+, ;