@,@,O,O, , , , , , , ,O,O,O,=;
@,@,O, , ,H,H, , , , ,Z, ,=, ;
@,@, , , ,$,$, , , , , ,=, , ;
@,@,O,O, ,$,$, , , , ,=,#,#, ;
@,@,O, , , ,=,=,=, ,=, ,#,#, ;
@,@, , , ,=,@,P,@,=, ,~, , , ;
O, , , ,=,@,T,T,T,@,=,~, , , ;
 , ,~,~,=,@,T,T,T,@,=, ,H,O,O;
H,H, , ,=,@,T,T,T,@,=, , ,O,O;
H,H, , , ,=,@,P,@,=, , ,B, , ;
 , , , ,=, ,=,=,=, , ,B, ,B, ;
 , , ,=, , , ,C,C,C,B, ,B, ,B;
$,$,=, , , ,C,C,C,C,C,B, ,B, ;
$,=, ,#,#, , ,~,~,~, , ,B, , ;
=, , ,#,#, , , , , , , , ,~,~;